Month,REGION 1,REGION 2,REGION 3,REGION 4,REGION 5,TOTAL
April,13,33,76,2,47,171
May,17,55,209,1,143,425
June,8,63,221,1,127,420
July,13,104,240,6,123,486
August,18,121,274,9,111,533
September,25,160,239,2,88,514
October,9,88,295,2,127,521
November,2,86,292,2,120,502
December,1,128,232,6,155,522
TOTAL,106,838,2078,31,1041,4094
